North-South
data/2DTerrain.dat
data/3DTerrain.dat
againstAI
scripts/
data/SoundDB.dat
40 24
BBBBBBBBBBBBBBBBBBBBBBBBBBBBBBBBB   RRRRRR
BBBBBBBBBBBBBBBBBBBBBBBBBBBBBBBB   RRRRRRR
BBBBBBBBBBBBBBBBBBBBBBBBBBBBBBB   RRRRRRRR
BBBBBBBBBBBBBBBBBBBBBBBBBBBBBB   RRRRRRRRR
BBBBBBBBBBBBBBBBBBBBBBBBBBBBBB  RRRRRRRRRR
BBBBBBBBBBBBBBBBBBBBBBBBBBBBBB  RRRRRRRRRR
BBBBBBBBBBBBBBBBBBBBBBBBBBBBBB  RRRRRRRRRR
BBBBBBBBBBBBBBBBBBBBBBBBBBBBBB  RRRRRRRRRR
BBBBBBBBBBBBBBBBBBBBBBBBBBBBBB  RRRRRRRRRR
BBBBBBBBBBBBBBBBBBBBBBBBBBBBB   RRRRRRRRRR
BBBBBBBBBBBBBBBBBBBBBBBBBBBB   RRRRRRRRRRR
BBBBBBBBBBBBBBBBBB      BBB   RRRRRRRRRRRR
BBBBBBBBBBBBBB               RRRRRRRRRRRRR
BBBBBBBBBBBBB               RRRRRRRRRRRRRR
BBBBBBBBBBBB   RRR      RRRRRRRRRRRRRRRRRR
BBBBBBBBBBB   RRRRRRRRRRRRRRRRRRRRRRRRRRRR
BBBBBBBBBB   RRRRRRRRRRRRRRRRRRRRRRRRRRRRR
BBBBBBBBBB  RRRRRRRRRRRRRRRRRRRRRRRRRRRRRR
BBBBBBBBBB  RRRRRRRRRRRRRRRRRRRRRRRRRRRRRR
BBBBBBBBBB  RRRRRRRRRRRRRRRRRRRRRRRRRRRRRR
BBBBBBBBBB  RRRRRRRRRRRRRRRRRRRRRRRRRRRRRR
BBBBBBBBBB  RRRRRRRRRRRRRRRRRRRRRRRRRRRRRR
BBBBBBBBB   RRRRRRRRRRRRRRRRRRRRRRRRRRRRRR
BBBBBBBB   RRRRRRRRRRRRRRRRRRRRRRRRRRRRRRR
BBBBBBB   RRRRRRRRRRRRRRRRRRRRRRRRRRRRRRRR
BBBBBB   RRRRRRRRRRRRRRRRRRRRRRRRRRRRRRRRR
10
4 5
13 5
23 6
6 11
3 17
34 18
24 17
16 18
34 12
35 4
